Engelsfälle - Angel Falls
Hexagon - Hexagon
Stinsbruck - Stornway
??? - East Stornway (Island)

Siechau - Coffinwell
Quarantomben - Quarantomb
Bühltau - Zere
Schloss Schickstal - Brigadoom
Turm des Schlafens - Tower of Nod

Allesneu-Abtei - Alltrades Abbey
Labskausen - Port Llaffan
Fort Bieldung - Tower of Trades
Gruselige Grotte - Tywil Cave

Altpier - Slurry Quay
Welkham - Dourbridge
Neu-Bühltau - Zere Rocks
Blühmlingen - Bloomingdale
Einsame Küste - Lonely Coast

Wasaba - Gleeba
??? - Djust Desert (Island)

Batsureg - Batsureg
Jägerjurten - Hunter's Yurts
Gerzuun - Gerzuu
Ulbaruun - Ulbaruun
??? - Urdus Marshland
??? - Ondor Cliffs

Schweinspickel Schule - Swinedimples Academy
??? - Hermany
Phantombaum von Humidia - Pluvi Isle
??? - Cringle Coast

Wurmwald - Wormwood Creek
Brennbergen - Upover
Olle Kuhle - The Bowhole
??? - Wyrmneck
??? - Wyrmwing / Wyrmtail
??? - Western Wormwood (Island)

Fiese Festung - Gortress
Schloss Schroffenheim - Gittingham Palace
??? - Khaalag Coast

